%%%%%%%%%%%%%%
%...    .....%
%.%%%%%%     %
%..     P    %
%%%%%%%%%%%%%%
